{
  "dimensiones": {
    "alto": 12,
    "ancho": 16
  },
  "terrenos": {
    "leyenda": {
      "sabana": "S",
      "desierto": "D",
      "pantano": "P",
      "Acantilado": "A",
      "Agua": "W"
    },
    "mapa": [
      ["S", "S", "S", "S", "S", "S", "S", "A", "A", "A", "A", "S", "S", "S", "S", "S"],
      ["S", "A", "A", "A", "A", "S", "S", "S", "A", "A", "S", "S", "S", "S", "S", "S"],
      ["S", "A", "A", "S", "A", "S", "S", "S", "S", "S", "S", "S", "S", "S", "S", "S"],
      ["S", "A", "S", "S", "S", "S", "S", "S", "S", "S", "S", "S", "S", "S", "S", "S"],
      ["S", "A", "S", "S", "S", "S", "W", "W", "S", "S", "S", "S", "S", "S", "S", "D"],
      ["S", "S", "S", "S", "S", "S", "W", "W", "W", "W", "S", "S", "S", "S", "S", "D"],
      ["S", "S", "S", "S", "S", "W", "W", "W", "W", "S", "S", "S", "S", "S", "D", "D"],
      ["S", "S", "S", "S", "S", "S", "S", "W", "S", "S", "S", "D", "D", "D", "D", "D"],
      ["S", "S", "S", "S", "S", "S", "S", "S", "S", "S", "S", "S", "S", "D", "D", "D"],
      ["P", "S", "S", "S", "S", "S", "S", "S", "S", "S", "S", "S", "S", "D", "D", "D"],
      ["P", "P", "P", "S", "S", "S", "S", "P", "S", "S", "S", "S", "S", "S", "D", "D"],
      ["P", "P", "P", "P", "P", "P", "P", "P", "S", "S", "S", "S", "S", "S", "S", "D"]
    ]
  }
}